111111
1PEC11
111111


/// flood flill q diga que no es vlaido
// exit que no sea solido
